x x x x x x x x x x x x x x x x x x y x 
x y y y y y x x y y y x y y x i y x e x 
x y x x x y i x y x y y y x x x y x y x 
x y y y x x x x y x x y x x y x y x y x 
x y x y y y y e y x y y y y y x y x y x 
x y x x x x y x y x x y x x x x y x y x 
x y y y y x y x y x y y y y y y y x y x 
x y x x y x y x y x x y x x y x x x y x 
x i x y y x y x y y y y y x e y y x y x 
x x x y x x x x x x x x x x y x y x y x 
x y x y x y y x y x y y y x y x y x y x 
x y y y y y x x y y y x x x y x y y y x 
x y x x x y x y y x y y y x i x x x y x 
x e y y x x x x y x x x y x x x y y y x 
x y x y y y y y y x y y y y y x y x y x 
x y x x x x y x y x y x x x x x y x x x 
x y y y y x y x y x y x y x y y y x i x 
x y x x y x y x y y e y y x y x x x y x 
x z x i y x y x y x y x y y y y y y y x 
x x x x x x x x x x x x x x x x x x x x