w w w w w w w w w w w w w w w w w w w w 
w w w w w w w w w w w w w w w w w w w w 
w w w w w w w w w w w w w w w w w w w w 
w w w w w w w w w w w w w w w w w w w w 
w w w w w w w w w w w w w w w w w w w w 
w w w w w w w w w w w w w w w w w w w w 
w w w w v v v w w w w v v v w w w w w w 
w w w w r r r w w w w r r 1 w w w w w w 
w v v v r w r w v v v r w r w v v v v v 
w x r r r w r w r r a r w r w r r r a r
w w w w w w r v r w w w w r v r w w w w 
w w w w w w 4 r r w w w w r r r w w w w 
w w w w w w w w w w w w w w w w w w w w 
w w w w w w w w w w w w w w w w w w w w 
w w w w w w w w w w w w w w w w w w w w 
w w w w w w w w w w w w w w w w w w w w 
w w w w w w w w w w w w w w w w w w w w 
w w w w w w w w w w w w w w w w w w w w 
w w w w w w w w w w w w w w w w w w w w 
w w w w w w w w w w w w w w w w w w w w
