w w w w w w w w w w w w w w w w w w w w
w w w w w w w w w w w w w w w w w w w w
w w w w w w w w w w w w w w w w w w w w
w w w w w w w w w w w w w w w w w w w w
w w w w w w w w w w w w w w w w w w w w
w w w w w w w w w w w w w w w w w w w w
w w w w w w w w w w w w w w w w w w w w
w w w w w w w w w w w w w w w w w w w w
w v w v v v v v v v v v v w v v v w v w 
w r w r r r r r r r r r r w r r r w x w 
w r v v v r r w r v v v r w r w r v r w 
w b r r r r w v r r r 2 v w r w r r r w 
w r v v w r w r r w r r r w 2 w v v r w 
w r r r v v v v r w v v r w r v r r r w 
w r w r r r r r r w r r r w r r r w r w 
w r v v v w r w r w r w v w v v r w v w 
w r r r r w r w r v r v r w r r r w 5 w 
w r w v r w r w r r b r r v r v v v r w 
w c w 2 r w r w r w r w r r r r r r r w 
w r w w w w w w w w w w w w w w w w w w