w w w w w w w w w w w w w w w w w w w w 
w w w w w w w w w w w w w w w w w w w w 
w w w w w w w w w w w w w w w w w w w w 
w w w w w w w w w w w w w w w w w w w w 
w w w w w w w w w w w w w w w w w w w w 
w w w w w w w w w w w w w w w w w w w w 
w w w w w w w w w w w w w w w w w w w w 
w w w w r r r w w w w r r i w w w w w w 
w w w w r w r w w w w r w r w w w w w w 
w x r r r w r w r r e r w r w r r r e r
w w w w w w r w r w w w w r w r w w w w 
w w w w w w i r r w w w w r r r w w w w 
w w w w w w w w w w w w w w w w w w w w 
w w w w w w w w w w w w w w w w w w w w 
w w w w w w w w w w w w w w w w w w w w 
w w w w w w w w w w w w w w w w w w w w 
w w w w w w w w w w w w w w w w w w w w 
w w w w w w w w w w w w w w w w w w w w 
w w w w w w w w w w w w w w w w w w w w 
w w w w w w w w w w w w w w w w w w w w
