w w w w w w w w w w w w w w w w w w w w
w w w w w w w w w w w w w w w w w w w w
w w w w w w w w w w w w w w w w w w w w
w w w w w w w w w w w w w w w w w w w w
w w w w w w w w w w w w w w w w w w w w
w w w w w w w w w w w w w w w w w w w w
w w w w w w w w w w w w w w w w w w w w
w w w w w w w w w w w w w w w w w w w w
w w w w w w w w w w w w w w w w w w w w 
w r w r r r r r r r r r r w r r r w x w 
w r w w w r r w r w w w r w r w r w r w 
w e r r r r w w r r r i w w r w r r r w 
w r w w w r w r r w r r r w i w w w r w 
w r r r w w w w r w w w r w r w r r r w 
w r w r r r r r r w r r r w r r r w r w 
w r w w w w r w r w r w w w w w r w w w 
w r r r r w r w r w r w r w r r r w i w 
w r w w r w r w r r e r r w r w w w r w 
w e w i r w r w r w r w r r r r r r r w 
w r w w w w w w w w w w w w w w w w w w