w w w w w w w w w w w w w w w w w w w w
w w w w w w w w w w w w w w w w w w w w
w w w w w w w w w w w w w w w w w w w w
w w w w w w w w w w w w w w w w w w w w
w w w w w w w w w w w w w w w w w w w w
w w w w w w w w w w w w w w w w w w w w
w w w w w w w w w w w w w w w w w w w w
w w w w w w w w w w w w w w w w w w w w
w d w d d d d d d d d d d w d d d w d w 
w r w r r r r r r r r r r w r r r w x w 
w r d d d r r w r d d d r w r w r d r w 
w e r r r r w d r r r i d w r w r r r w 
w r d d w r w r r w r r r w i w d d r w 
w r r r d d d d r w d d r w r d r r r w 
w r w r r r r r r w r r r w r r r w r w 
w r d d d w r w r w r w d w d d r w d w 
w r r r r w r w r d r d r w r r r w i w 
w r w d r w r w r r e r r d r d d d r w 
w e w i r w r w r w r w r r r r r r r w 
w r w w w w w w w w w w w w w w w w w w