y y y y y y y y y y y y y y y y y y y y
y y y y y y y y y y y y y y y y y y y y
y y y y y y y y y y y y y y y y y y y y
y y y y y y y y y y y y y y y y y y y y
y y y y y y y y y y y y y y y y y y y y
y y y y y y y y y y y y y y y y y y y y
y y y y y y y y y y y y y y y y y y y y
y y y y y y y y y y y y y y y y y y y y
x x x x x x x x x x x x x x x x x x x x 
x y x y y y y y y y y y y x y y y x z x 
x y x x x y y x y x x x y x y x y x y x 
x e y y y y x x y y y i x x y x y y y x 
x y x x x y x y y x y y y x i x x x y x 
x y y y x x x x y x x x y x y x y y y x 
x y x y y y y y y x y y y x y y y x y x 
x y x x x x y x y x y x x x x x y x x x 
x y y y y x y x y x y x y x y y y x i x 
x y x x y x y x y y e y y x y x x x y x 
x e x i y x y x y x y x y y y y y y y x 
x y x x x x x x x x x x x x x x x x x x
