x x x x x x x x x x x x x x x x x x x x 
x x x x x x x x x x x x x x x x x x x x 
x x x x x x x x x x x x x x x x x x x x 
x x x x x x x x x x x x x x x x x x x x 
x x x x x x x x x x x x x x x x x x x x 
x x x x x x x x x x x x x x x x x x x x 
x x x x x x x x x x x x x x x x x x x x 
x x x x y y y x x x x y y i x x x x x x 
x x x x y x y x x x x y x y x x x x x x 
x z y y y x y x y y e y x y x y y y e y
x x x x x x y x y x x x x y x y x x x x 
x x x x x x i y y x x x x y y y x x x x 
x x x x x x x x x x x x x x x x x x x x 
x x x x x x x x x x x x x x x x x x x x 
x x x x x x x x x x x x x x x x x x x x 
x x x x x x x x x x x x x x x x x x x x 
x x x x x x x x x x x x x x x x x x x x 
x x x x x x x x x x x x x x x x x x x x 
x x x x x x x x x x x x x x x x x x x x 
x x x x x x x x x x x x x x x x x x x x
