w w w w w w w w w w w w w w w w w w w w 
w w w w w w w w w w w w w w w w w w w w 
w w w w w w w w w w w w w w w w w w w w 
w w w w w w w w w w w w w w w w w w w w 
w w w w w w w w w w w w w w w w w w w w 
w w w w w w w w w w w w w w w w w w w w 
w w w w d d d w w w w d d d w w w w w w 
w w w w r r r w w w w r r i w w w w w w 
w d d d r w r w d d d r w r w d d d d d 
w x r r r w r w r r e r w r w r r r e r
w w w w w w r d r w w w w r d r w w w w 
w w w w w w i r r w w w w r r r w w w w 
w w w w w w w w w w w w w w w w w w w w 
w w w w w w w w w w w w w w w w w w w w 
w w w w w w w w w w w w w w w w w w w w 
w w w w w w w w w w w w w w w w w w w w 
w w w w w w w w w w w w w w w w w w w w 
w w w w w w w w w w w w w w w w w w w w 
w w w w w w w w w w w w w w w w w w w w 
w w w w w w w w w w w w w w w w w w w w
