w d d d d d w w d d d w d d w d d w r w 
w r r r r r d w r r r d r r w i r w e w 
w r d d w r i w r w r r r w d w r w r w 
w r r r d d d d r w d r d d r w r w r w 
w r w r r r r e r w r r r r r w r w r w 
w r d d d w r w r w d r d d d d r w r w 
w r r r r w r w r w r r r r r r r w r w 
w r w d r w r w r d d r d w r d d w r w 
w i w r r w r w r r r r r w e r r w r w 
w d w r w d d w d w d d d w r w r w r w 
w r d r d r r w r d r r r w r w r d r w 
w r r r r r w d r r r d d w r w r r r w 
w r d d w r w r r w r r r w i w d d r w 
w e r r d d d d r w d d r d d w r r r w 
w r w r r r r r r w r r r r r w r w r w 
w r d d d w r w r w r w w w d d r w d w 
w r r r r w r w r d r d r w r r r w i w 
w r w d r w r w r r e r r d r d d d r w 
w x w i r w r w r w r w r r r r r r r w 
w w w w w w w w w w w w w w w w w w w w