w w w w w w w w w w w w w w w w w w r w 
w r r r r r w w r r r w r r w i r w e w 
w r w w w r i w r w r r r w w w r w r w 
w r r r w w w w r w w r w w r w r w r w 
w r w r r r r e r w r r r r r w r w r w 
w r w w w w r w r w w r w w w w r w r w 
w r r r r w r w r w r r r r r r r w r w 
w r w w r w r w r w w r w w r w w w r w 
w i w r r w r w r r r r r w e r r w r w 
w w w r w w w w w w w w w w r w r w r w 
w r w r w r r w r w r r r w r w r w r w 
w r r r r r w w r r r w w w r w r r r w 
w r w w w r w r r w r r r w i w w w r w 
w e r r w w w w r w w w r w w w r r r w 
w r w r r r r r r w r r r r r w r w r w 
w r w w w w r w r w r w w w w w r w w w 
w r r r r w r w r w r w r w r r r w i w 
w r w w r w r w r r e r r w r w w w r w 
w x w i r w r w r w r w r r r r r r r w 
w w w w w w w w w w w w w w w w w w w w